1111111111111111111111
1000000000000000001111
1CCCCCCCCCCCCCCPE11110
1111111111111111111111